00000000000001000001
01110101111101011101
00000101000101000101
01111101010101110101
01000001010100010101
01011111110101010101
01000000010101000101
01111101010111111101
00000101010100000001
11110101010101111101
00000101000100010001
01111111111111011101
00000001000101000101
01111101110101110111
01000100010100010001
01110111010111010101
00000001000101010101
01011101011101011101
01000101000001000001
11111111111111111100