0100010001100000000000001000000000010000000000000000000000000000101000010000000100000000010000000111
0100011100110001111001101100100000011111101101111010010011011000001111010001111100110100010111100111
0000000100000000000000000000000001000000100000000000000000000000000000010000000100000100000000000001
0010010100101001101000001011010000110011111000000100111000011110000001100010000001100111111111111100
0010000000100000000000001000000000000000000000000000000000000000000000000010100000000000010000000000
0000100000000001010000000010100100010001000000000111100100010011011000000010000100000000010000000010
0000001001111001000010000010000000000101001100000000010111010000000010000000000000000000010000000000
1100000000000000001000000000001000001100000000000001010000010000001000010001000000000000010101100101
0100000000000000000000000000000000111100011001100000010000000000000000000001000000000000010000000000
0100000100000000000000000000000000100000000000000000010111111011100000111101000001101100011000000010
0000010000001000000000000001001000101000001100000000010000000000001000000101000100000001000001000000
1000010000000010000100000001001000000000000001100000010000000000000000000100000000000001100000010000
0000000000000000000000000001000011010001101000000000010000000000001100000000000000000000000000000000
0000000000000010001001001101000000000000101000100000000000010000000000110000000000000000010001100000
0001000000000000000000000000001100100110111000111010000000000000010000000100001000000111000000011000
0000000000000000000000000000000000000000000000000000001100000000000000100001000000000000000000000000
0100011000000001100000000001011000001101001001000100000010000001000000010000000001000000100000000000
0100000100001100000000000000000000000001000000000100000000000001000101000000110100000000100000000000
0000100110000000000111101111001111011001110010001100011001110000000001001100000001100000000000000000
0001000000010000000000000000000000000000000010000000000000000000000000000000000000000000000001000000
0001000101010100100001011010010010010000001000000000110100100110001100000001000000000000000000000000
0000000000000100000101000000000000000000000010000000000000000000000000000000000000000110000000000000
0000001010000100000101110100101111100011000110111110111011110001000011000011000101110000100011111111
1001000000000100000000000000000000000000000000000010001000000000000000011000000100010010000000000000
0000000000000001011000000100001000010000000001001010101000000000100000000000100011000000000000000000
0100110000000000000000010000000000000000000000000010100000000000100000000000100000000000000000000000
0100000001111100000100111110011100111101111101101101111110110100100001000000000011001000000000000000
0100000001000001100000000010000000000001000000100000000010000100000111000101100000001000000000000100
0100011000000111100001100001111010111111000000111000011010000000010001010000000110100000000000000000
0110000000000000000000000000000010000000000000000000000010000001011101000100110000000000011111000000
0000000100000000001011001001001001110010000000001110100010000000000001000000000000000000000001000001
0000010000001100000000001000000010000100000010000000001010000000011000010010001000000110101101000000
0000000000000000110000001011110000000000110000000000001000001000000000010000100000000000000001000000
0011000000000010000000000000000110000000000000000011100000000000000001100011111100000000000000000000
0000000000000010000000000101100000000000000000000000001000000100000000000000000001110010100000000000
0000000000000000000000000000000101100011000000000000000000000000001011010100101000000000000000000000
0000000000001000011111000011100100000000000011111000000100000011000000000001101000000001000000000000
0000100100000000000000000000000000000000000000001000000000001000000101100000001000001000000000000000
0000000100000000110110000100000000000000000000000000001000101000100001000000100000001010100000000000
0101100011000000000000000000000000000011110010000010100000100010100000000000000100000000000000000000
0100000000001101101110001100000001010000000010101010000000111010111111010000000000000100000000000001
0001010000100000001000000000000001010000000010100000001010000010000000010100100000010000000000000101
0000000000001000011011101100111111000000000000011110101000001101011110010001111100000000000000000000
0100111000100000001000000000000000000000010001000000100000100001010000011100000000000111111111000000
0100000000100000001000000000011000001101110001001100000000100000010000000000001001000000010000000000
1100000000001000000001100000000000000000010000000000100000000010000000000000001000000000000010000010
0000110000000011100000000000000110011011000001111100101000000000000001100001001011111100000000100000
0000000001001000000000000100110000001000000100010000100000000010000001000000000010000000000000001001
0000000100000000000000000000000000000010010001001000000001101010110010000000000000000000100000001100
0000000000000111101000000000000000000000000100000000000000000000001110000000000000001000000100000000
0111101111110000001000001111111110011111110111111011111110110000000010110100111111100000010001111011
0100001000000001001010000000000010000100010000000000000010001000001010100000001100100000010000000000
0000001000111101111000001100111011110101001111100010111111111000101000001111001111000000000001111110
1100100000000000000000001000000000000100000000000010000000000010101000000000000000001000000000000000
0100010000001011110010001000001100000001110011000011000000011010000000111100000110100010000011110111
0111010100001000000000000000000000000000000000000000000000000000000000000000000010000000100000000001
0100010100000010000000000101010000000010000000010110100101110000000000001010001010000110001100001001
0000010011100000000000000000000000000000000000000000000000000000110011100000000011100000000010000000
1100000010000000000100111000100000000100000000000000001110100000000010000000000000100000001000001000
0100011010000000000000000010000000000000001011111001000000000000101011001100110000100100011000000000
0001001000011000101000001100000000100000000000000000001100000000101000000000000000000000000000000010
0000000001000000001000000000000000001000000000001100000100000000000110000110000001100010000000100000
0000000000000100001010010000100000010000000000000000010001000000000000000000010000000000001001110000
0000000000000000001000000000000000000000000000000011000000010000000000101100000000010000000000000000
0000000000000000000000000000000000101010011010000000000001000000000000100000001000010000011100101000
0000100000000000110100000000000000000000000000000000000000000000000001001000100000100011000000100000
0100000000000000000000011111000000010000100101111111110011011111011000000000000000000000000000000000
0100011000000000000000000000000000000000100100000000010000010101000000000011111101000110110001000000
1100000000011000000000000000001001000011100000000111000000010100000000000000000001000000000001000001
0000001100000001001000000000100000000000100001000000000100010100000000000100000000001000000000000000
0001000000000100001000000001100000000000000001000000000100010100010000000000000000000000011001100010
0011000100010001000010100000000000000011000000000100000100000000000000001110111111100001000000000000
0010010000011101000000000011000000000000000000000100000100000000100000000010010000000000001100000001
0000000000000001111100100000000000100000000000000100000000000000001110000000000111010110100101110100
0001000000000000000000100010000000101000000000000000000100001100000010011000100001000110100001000100
0000000000000011111111111000000000000001010000000000001100000000111000000000001101111111100000000100
0011100000000000000000000000110110000001010111100111001111000110000000000000000000000000000110000100
0000000100000000100010000000000000000000010100000011000000000100100100000010000010000100000000001000
0000000000000010000000000000001101000000010100000010101110000000000000000010000010000000000101101010
0000000010000000000000110000000000000000000100000000000000100000001100111111110010000000001100000000
1111000000010000000000000000001011101100000101101000010000000000100000000000000000000000000001110000
0000000000000001000000000001001000000000000100000000100001000000000000000000100000000000011100010000
0011100000000000010000100000000000111011111011010000100001001000000000100000000000001000000000000011
0000101000110000000000100000000110100000001000010000000000100000000000101000000000000010000000000000
0100100000000000000000100000000000010000100011010000000010011000000100001000000000000010000000010000
0000011000011000000001100000000011000000000000000000000000000000000000011100000000000000001000000000
0010000011011000010000000000000000010011000000000000001100111001100000000100000001010111101011111111
0000000000000001010000000000100001000000000000000000000000000000000000000000000001000000100000000000
0100000011100110001100000000000000001100000000000011110101100100010111100000000000000000011101100000
0000000000000000000001000001000000000000000000000000000000000000000000000001000000000000000000000100
0100000001001101000111000001000000000000000000110000011000010010001010000000000000000000100000000110
0000100000000000000001000000000000000001000000000000000000000000000010101000010000000000000000000000
0000100000011011111101110001100000000001100001101100111000001100000000101000000000100000010000010011
0100000011000000000001000000000000100000000000000000000000000000000000001000000000000000000000000000
1001000000110000000001000000000000100000000111000101100100001010000010000010000000000000000010000000
1100000110110001010000010001000000010000000000000000000000001010001000001000000010000000010000000000
0100000000001001000000000000001100000111100000000110000001100010100000001011010000000000000110001000
0001011100101000011100000000000000000010000011110000000000011110000010000010010111000000100000001000
1001000000100000010001000000011000011000001000000000010011010000000000000010000001000000101001000000
1001000000110000000000001000000000000011000000000000000000000000010000000000100000000000000000100000