00000001000100000000000000010001000000000000000001
01010111010101010111110111010101110101011111111101
00010001010101010001010001010100010101010000010001
01111101010101010101011101010111010101110101110111
00000101010101010100010001010100010100010101010001
01110111010101111111110101110101110101010101011101
00010000010100010000000101000100010101000100010001
11011111110111010101111111011101010101110111110101
00000000010000010100010001000101010100010100000101
01111111011111010101110101011101010101010101111111
00000101000001010100010101010001000101010100010001
01110101011101110111010101010101111111010111011101
01010001010100010001000101010100000100010001000101
01011101010111010111111111010101110101010111110101
00010001000100010000000000010100010101010100000101
01110111111101111111111111010111010101110101111101
00010000000100010000000001010001010100010100000101
01111111010111011111111101110101011111011111110101
00010000010001000000000001000101000101000100010101
11010111110111111101111111010101110101110101010101
00010000010100000100000001010101010001000101000101
01110111011101111111111111010101010111011101110101
00010001000100010000000000010100010100000100010101
01110111110101110101111101111111110101111101010101
00010100000100000101000100000101000100010001010101
11011101111111111101010101110101011111011111011101
00010000010000000100010100010101000001000001000101
01110111110101011111110101110101111101111101110101
00010000000101000000010100010001000101000100010101
11010101110111111111011111011111110101010111010101
01010100010000000001000001000100000101010100010001
01010111111111111111111101010101110101011101111111
00010000010001000000000001010101000101000101000001
11111111010101011101111111110101011101110101011101
00000100010101010000010000010001000100010101000101
01110111110101011111010111011111110101010101111101
00010000000101000101010001010000000101000101000001
01011101111101010101011101010111011101111101010111
01000100000101010001000101010100000100000101010001
01110111110101111101110111010111111111110101010111
00010000010100000001000100010001000000000100010001
01010101011101111111011101011101011111111111111101
01010101000101000001000001000101000000000000010001
01111101110111011101011111111101011111111111011111
00000100010001000101010000000001010001000001000001
11110111111101110111110101111101010101011111111101
00010001000000010000000101000101000101000100000001
01011101011111011111111101010111111101110101011111
01000001000111000000000100010000000100010001000001
11111111111111111111111111111111111111111111111100